{
  "禄": "祿",
  "祿": "祿",
  "国": "國",
  "囯": "國",
  "冲": "沖",
  "带象": "帶象",
  "录": "錄",
  "祿": "祿",
  "官": "官",
  "印": "印",
  "財": "財",
  "殺": "殺",
  "沖": "沖",
  "刑": "刑",
  "合": "合",
  "破": "破",
  "穿": "穿",
  "墓": "墓",
  "庫": "庫"
}